-22
23
-10
13
111111111111111111111111111111111111111111111
100000000000000000000000000000000000000000001
100000000000000000000000000000000000000000001
100000000000000000000000000000000000000000001
100000000000000000000000000000000000000000001
100000000000000000000000000000000000000000001
100000000000000000000000000000000000000000001
100000000000000000000000000000000000000000001
100000000000000000000000000000001100000000001
100000000000000000000000011111110000000000001
100000000001000000000000011111110000000000001
100000000000000000000000011111110000000000001
100000000000010000000000011111110000000000001
100000000000000000000000011111110000000000001
100000000000000000000000011111110000000000001
100000000000000000000000011111110000000000001
100000000000000000000000000000000000000000001
100000000000000000000000000000000000000000001
100000000000000000000000000000000000000000001
100000000000000000000000000000000000000000001
100000000000000000000000000000000000000000001
100000000000000000000000000000000000000000001
111111111111111111111111111111111111111111111
