-22
21
-12
11
1111111111111111111111111111111111111111111
1000000000000000000000000000000000000000001
1000000000000000000000000000000000000000001
1000000000000000000000111110011111110000001
1000000000000000000000100000000000010000001
1000000000000000000000100000000000010000001
1000000000000000000000100000000000010000001
1000000000000000000000000000000000000000001
1000000000000000000000000000000000000000001
1000000000000000000000111110000000010000001
1000000000011111000000000010000000010000001
1000000000011111000000000010000000010000001
1000000000000000000000000010011111110000001
1000000000000000000000000000000000000000001
1000000000000000000000000000000000000000001
1000011000000000000000111110000000000000001
1000011000000000000000111110000000000000001
1000000000000000000000000000000000000000001
1000000000000000000000000000000000000000001
1000000000000000000000000000000000000000001
1000000000000000000000000000000000000000001
1000000000000000000000000000000000000000001
1111111111111111111111111111111111111111111
