-22
21
-12
12
0000000000000000000111100000000000000000000
1111111111111111111100111111111111111111111
1000000000000000000000000000000000000000001
1000000000000000000000000000000000000000001
1000000000000000000000000000011111110000001
1000000000000000000000000000000000010000001
1000000000000000000000000000000000010000001
1000000000000000000000000000000000010000001
1000000000000000000000000000000000000000001
1000000000000000000000000000000000000000001
1000000000000000000000000000000000010000001
1000000000011111000000000000000000010000001
1000000000011111000000000000000000010000001
1000000000011111000000000000011111110000001
1000000000011111000000000000000000000000001
1000000000000000000000000000000000000000001
1000011000000000000000111110000000000000001
1000011000000000000000111110000000000000001
1000000000000000000000000000000000000000001
1000000000000000000000000000000000000000001
1000000000000000000000000000000000000000001
1000000000000000000000000000000000000000001
1000000000000000000000000000000000000000001
1111111111111111111111111111111111111111111
