-22
21
-13
17
1111111111111111111111111111111111111111111
1000000000000000000000000000000000000000001
1000000000000000000000000000000000000000001
1000000000000000000000000000000000000000001
1000000000000000000000000000000000000000001
1000000000000000000000000000000000000000001
1000000000000000000000000000000000000000001
1000000000000000000000000000000000000000001
1000000000000000000000000000000000000000001
1000000000000000000000000000000000000000001
1000000000000000000000000000000000000000001
1000000000000000000000000000000000000000001
1000000000000000000000000000000000000000001
1000000000001000000000100000000000000000001
1000000000000100000001000000000000000000001
1000000000000010000010000000000000000000001
1000000000000001000100000000000000000000001
1000000000000000101000000000000000000000001
1000000000000000010000000000000000000000001
1000000000000000101000000000000000000000001
1000000000000001000100000000000000000000001
1000000000000010000010000000000000000000001
1000000000000100000001000000000000000000001
1000000000001000000000100000000000000000001
1000000000000000000000000000000000000000001
1000000000000000000000000000000000000000001
1000000000000000000000000000000000000000001
1000000000000000000000000000000000000000001
1111111111111111111100111111111111111111111
0000000000000000000111100000000000000000000
